#######N########
#--------------#
#--------------#
#--#--#--#--#--#
#-----------####
#--##--##---####
#--------------#
#---------######
#--#####-------E
#-----##-------#
#-----##--###--#
#-----##--###--#
W-----##--###--#
#-----##-------#
########-------#
########S#######