#############N###
#---------------#
#-#-#-###-#-#-#-#
W-------#---#---#
###-#-###-#-###-#
#---#---#-------#
#-#-#-#-#-#-###-#
#-----#---------E
###S#############