##N#############
#--------###---#
W--------------E
######---------#
######---####--####
#----#---###------#
#--------###------#
######S############