####N####
#-------#
#-------#
#-------#
W-------E
#-------#
#-------#
#-------#
####S####