##N#########
#----------#
#----------#
#----------#
######---###
######---###
#--------###
#----------E
#####------#
    #------#
    #------#
    ########