#######N########
#------------cvv
#--------------#
#--#--ythj--#--#
#-----------####
#--##--##---####
#--------------#
#-----tyjh######
#--#####-------E
#-----##-------#
#-----##--###--#
>>;;;;##--###--#
<<<<<<##--#,.,./
#-----##-------#
########-------#
########S#######