##N#############
#--------###---#
W--------------E
######---------#
######---####--#
#----#---###---#
#--------###---#
######S#########