###########################
#-------------------------#
#-------------------------#
##############----------###
             #----------# 
             #----------##########################
             #-----------------------------------#
             #-----------------------------------#
             #-----------------------------------#
             #-----------------------------------#
             #####################################