##N#########
#----------#
#----------#
#----------#
######---###
######---###
#--------###
#----------E
#####------#
----#------#
----#------#
----########