##########
#--##----#
#--------#   #####
#--####--#####---#
#----------------E
#--####--#####---#
#--------#   #####
#----##--#
##########