    #####    #####    #####
    #---#    #---#    W---#
    #---#    #-#-#    ##-##
    ###-#    #---#    #---#
    #---#    #---#    #-#-#
    #-###    #-#-#    #-#-#
    #---#    #---#    #---#
    ###-#    #---#    ##-##
    #---#    #-#-#    #---#
#####---######---######---#####
#-----------------------------E
#--############################
#-----##---------#------------#
#-###----##--##--######--#----#
#-----##-----------------#----#
##################-#---#-######
                 #-#---#-#
                 #-#---#-#
                 #-#---#-#
                 #-------#
                 ####S####