##########
#-#----#-#
#-##--##-#
#--------#
#--####--#
#--------#
#-##--##-#
#-#----#-#
#-#----#-#####N#####
#-#--------##------#
#---#--##--##------#
#---#------##---##-#
#---#--##-------##-#
#---#------##---##-#
####################