##N############################
#-----------------------------#
#---##------------------------#
#---##------------------------E
#---##------------------------#
#-----------------------------#
############----###############
           #----#
           #----#
           #----#
    ########----#
    #--------##-#
    W-----------#
    #############