#######
#-----#
#-###-#
#-----#
#-----E
#-----#
#-###-#
#-----#
#######