#######
#-XX--#
#-###-#
#-----#
#-PV--E
#-----#
#-###-#
#-XX--#
#######