##########
#--##----#
#----X---#   #####
#--####--#####---#
#-V----X-------P-E
#--####--#####---#
#---X----#   #####
#----##--#
##########