####################
#---##----#--------#
#------##-----#--###
#---##----#---#----E
###########---#--#-#
#-------------#----#
##S#################