####################
#---##-X--#------X-#
#-PV---##---X-#--###
#---##--X-#---#----E
###########-X-#--#-#
#-------------#----#
##S#################