####################
#---##-X--#------X-#
#-X----##---X-#--###
#---##--X-#---#----E
###########-X-#--#-#
#-------------#----#
##S#################