               ##########
               #--------E
               #--------#
               ######---#
               #--XX----#
               #--XX----#
               ###--##--#
################----##-X#
#-------------------##--#
#---X---#################
###---###
#-------#######
#--###--------#
#-XX-#--##--X-#
#----#--------#
#--#-XX-#######
#--#----#
#--###--#
#-------#
####S####