               ##########
               #--------E
               #--------#
               ######---#
               #--------#
               #--------#
               ###--##--#
################----##--#
#-------------------##--#
#-------#################
###---###
#-------#######
#--###--------#
#----#--##----#
#----#--------#
#--#----#######
#--#----#
#--###--#
#-------#
####S####