#############N###
#------X-X------#
#-#-#-###-#-#X#-#
W-------#-X-#---#
###-#-###-#-###-#
#---#-X-#----X--#
#-#-#-#-#-#-###-#
#-----#---------E
###S#############