#############N###
#------X-X------#
#-#-#-###-#-#X#-#
W------V#-X-#---#
###-#-###-#-###-#
#-P-#-X-#----X--#
#-#-#-#-#-#-###-#
#-----#---------E
###S#############