#########################
#----#---------#----#---#
#----#---------#----#---#
W----###--###--#----#--##
#---------#----####-----#
#---------#-------------#
######################--#
                  #-----#
                  #--####
                  #-----#
                  ####--#
                  #-----#
###################--####
#-----##--#-------#-----#
#---------#-------#-----#
#-----#-------#---------#
#-###-#---##--#---------#
#-#-#-###################
#-#-#-#
#-#-#-#
###-#-#
#-----#
#-#####
#-----###################
#-----#------##---------#
#-----#--##---#--##---###
#-----------------------E
#-----#--##--#---##---###
#-----#------##--#------#
#########################