########################################################
#------##---#--X--------X--------#-X-#-X-X-#-----------#
#--##--##-X-#--##-----#---#----###---#-----#---##--##--#
W--##X-##----------##-##-##-##------##-##------##-X##--E
#--##--##---#--##-----#---#-----###-----#--#-X-##--##--#
#-----------#---X-------X---------#-X-X-#--#---##------#
########################################################