########################################################
#------##---#--X--------X--------#-X-#-X-X-#-----------#
#--##--##-X-#--##-----#---#----###---#-----#---##--##--#
W--##X-##----------##-##V##--P------##-##------##-X##--E
#--##--##---#--##-----#---#-----###-----#--#-X-##--##--#
#-----------#---X-------X---------#-X-X-#--#---##------#
########################################################