########################################################
#------##---#--X--------X--------#-X-#-X-X-#-----------#
#--##--##-X-#--##-----#---#----###---#-----#---##--##--#
E--##X-##----------##-##-##-##------##-##------##-X##--W
#--##--##---#--##-----#---#-----###-----#--#-X-##--##--#
#-----------#---X-------X---------#-X-X-#--#---##------#
########################################################