########################################################
#------##---#--------------------#---#-----#-----------#
#--##--##---#--##-----#---#----###---#-----#---##--##--#
E--##--##----------##-##-##-##------##-##------##--##--W
#--##--##---#--##-----#---#-----###-----#--#---##--##--#
#-----------#---------------------#-----#--#---##------#
########################################################