           ###N###           
           #-----#           
           #-----#           
           ###-###           
           ###-###           
           #-----#           
############-###-############
#---------------------------#
#-#####-#######--########---#
#-##--#---------------------#
#-##--#---###--##-------#---#
#-#--##--------##---###-#---#
#-#--##---###--####---------#
#-#-###--------##---###-#---#
#---#---###--####-------#---#
#---#-----------------###---#
#############################
