##########
#-#-XX-#-#
#-##--##-#
#------X-#
#--####--#
#---X----#
#-##--##X#
#X#----#-#
#-#-XX-#-#####N#####
#-#--------##------#
#---#--##--##------#
#-X-#---X--##---##-#
#-X-#--##-------##P#
#-V-#--X---##---##-#
####################