######N######
#-------##--#
#-------##XX#
#--##-P-##--#
#--##---##--#
#--#######--#
#-----------#
#--#-##-#---E
#--#-VX-#-###
#--#-##-#--X#
#----X------#
#############