######N######
#-------##--#
#-------##--#
#--##---##--#
#--##---##--#
#--#######--#
#-----------#
#--#-##-#---E
#--#----#-###
#--#-##-#---#
#-----------#
#############