######N######
#-------##--#
#-------##XX#
#--##---##--#
#--##-X-##--#
#--#######--#
#-----------#
#--#-##-#---E
#--#--X-#-###
#--#-##-#--X#
#----X------#
#############