               ######################
               #-------------#--##--E
               #--##--##-----#------#
               #####--####---#--##--#
               ###------######--##--#
               #----------##----##--#
##N#############-------#------------#
#---------#--------##################
#---#--#--#--------#
#---#----------#---#
#---#--##---#--#---#
#-----------#------#
################---#
               #---#
               #---#############
               #-----------#---#
               #---#--##---#-#-#
               #---#-----###---#
               #---#---------#-#
               #------##-------#
               #################