##############    ##N## 
#X----X-----X#    #---# 
######--######    #---# 
######--######    #---# 
#------------#    #---# 
#X----##--XX-######---# 
###---##-------##-----# 
#-----##--###--##-----# 
#-----##---X---##---X-# 
#-----##-------X------# 
####S########------#### 
            #-X##--#    
        #####------#####
        #------------# #
        #--#########-###
        #-X##------#---E
        #--##-XX-X-#####
        #-------X-----X#
        ################