##############    ##N##
#------------#    #---#
######--######    #---#
######--######    #---#
#------------#    #---#
#-----##-----######---#
###---##-------##-----#
#-----##--###--##-----#
#-----##-------##-----#
#-----##--------------#
####S########------####
            #--##--#
        #####------#####
        #------------# #
        #--#########-###
        #--##------#---E
        #--##------#####
        #--------------#
        ################