##N#########
#---#------#
#---#------###
#---###------#
#--------##--E
#---###------#
#----------###
#------#---#
#------#---#
#########S##