##N#########
#---#--XX--#
#-P-#------###
#---###------#
#------V-##--E
#---###------#
#---XX-----###
#------#---#
#------#---#
#########S##