##N#########
#---#--XX--#
#---#------###
#---###------#
#--------##--E
#---###------#
#---XX-----###
#------#---#
#------#---#
#########S##