########N########
#---------------#
#---------------#
##############--#
##############--#
##############--#
#-----#---------################
W---###--###----##-------------#
#--------#------##--###---###--#
##########---------------------E
#---------------##--###---###--#
#----------##---##-------------#
########---##---################
     # #---##---#
     ###-------##
     #-----##---#
     #-----##---#
     #----------#
     #---########
     #---#
     #---#
     #---#
     ##S##