########N########
#---------------#
#X--------------#
#########---##--#
#########-P-##--#
##############X-#
#-----#---------################
W---###X-###----##-------------#
#--------#--XXX-##--###--X###--#
##########--XV-----------------E
#X-----------X--##-X###---###--#
#X---------##---##--------X----#
########-X-##---################
     # #---##---#
     ###-X-----##
     #-----##---#
     #-----##-X-#
     #----------#
     #---########
     #---#
     #---#
     #---#
     ##S##