##N############################
#-----------X--##-X-##-----X--#
#---##-----##-------##-----##-#
#---##-XX-----V-##--##-###----E
#---##----##----##------X#-##-#
#----X----X-----##X------#----#
############-X--###############
           ##--##
           #----#
           #----#
    ########--X-#
    #--------##-#
    W--------P--#
    #############