##N############################
#-----------X--##-X-##-----X--#
#--X##-----##-------##-----##-#
#-X-##-XX-------##--##-###----E
#--X##----##----##------X#-##-#
#---------X-----##X------#----#
############-X--###############
           ##--##
           #----#
           #----#
    ########--X-#
    #--------##-#
    W-----------#
    #############