#####N##############################
#---------###----------------------#
#---###---------###-----##-##-##---#
#---------###-----------##-##-##---#
#---###---------###----------------#
#---------###-----------##-##-##---#
#---###---------###-----##-##-##---#
############-----------------------#
           #-----------------------#
           #----####################
           #-----------------#
           ####---#########--#
           #-----------------#
           #----##############
     #######-----------------#######
     #-------------##--------------#
     W----####-----##------####----E
     #----####-----##------####----#
     #-------------##--------------#
     ###############################