##N############################
#--------------##---##--------#
#---##-----##-------##-----##-#
#---##----------##--##-###----E
#---##----##----##-------#-##-#
#---------------##-------#----#
############----###############
           ##--##
           #----#
           #----#
    ########----#
    #--------##-#
    W-----------#
    #############