####N####       
#-------#       
#-------#       
#---#---#       
#---X---#       
#-------#       
#-X---X-########
#----------#---#
####--####-#-X-#
#--------#-#---#
#-X-##-X-#-#-X-#
#---XX---#-----#
##########-#####
       #-------#
       #---X---#
       #-------#
       #--####-#
       #XX#----#
       ####S####