####N####       
#-------#       
#-------#       
#-------#       
#-------#       
#-------#       
#-------########
#----------#---#
####--####-#---#
#--------#-#---#
#---##---#-#---#
#--------#-----#
##########-#####
       #-------#
       #-------#
       #-------#
       #--####-#
       #--#----#
       ####S####