#####N#####
#---------#
#---------#
#-#######-#
#----#----#
#---####--#
###--#----#
###--#----#
#-##-#--#-#
#----#----#
#--###--###
#----##---#
###--###--#
#----#---##
#-##-#--###
#----#----#
##--##-#--#
#----#-#--#
#-##-#-#--#
#----#----#
#---###---#
#---------#
#-###-###-#
#-##---##-#
#-##---##-#
#####S#####