#####N#####
#---------#
#---------#
#-#######-#
#---X#----#
#---####--#
###--#X---#
###X-#----#
#-##-#--#X#
#----#----#
#--###-X###
#--XX##---#
###--###-X#
#XX--#---##
#-##-#X-###
#--XX#----#
##--##-#XX#
#----#-#--#
#-##-#-#--#
#---X#-X--#
#---###---#
#---------#
#-###-###-#
#-##---##-#
#-##---##X#
#####S#####