    ##N##
    #---########
    #-------#X-#
    #-----#X-V-#
    ########---#
           ##--#
######     #X--#
#----#     #-###
W----#     #--X#
#--###     ###-#
#---X#     ##X-#
#-##-#######---#
#------X#------#
##----#-#-####-#
#X-##-#X#--X---#
#-------###----#
#-##-####---#--#
#-XX--------#XX#
#######-X-######
      #-#-#
      #---#
      #-P-#
      #---#
      ##S##