          #########
          #-X---XX#
          #----XX-#
          #---#####
          #---#    
####N######-X-#####
#-----------------#
###############-X-#
#---------X---#X-X#
W-------###-X-#---#
###########---#-X-#
#---------X---#---#
#--#-##########X-X#
#--#---X----------#
#S#################