          #########
          #-V---XX#
          #----XX-#
          #---#####
          #---#    
####N######-X-#####
#P----------------#
###############-X-#
#---------X---#X-X#
W-------###-X-#---#
###########---#-X-#
#---------X---#---#
#--#-##########X-X#
#--#---X----------#
#S#################