          #########
          #-------#
          #-------#
          #---#####
          #---#
####N######---#####
#-----------------#
###############---#
#-------------#---#
W-------###---#---#
###########---#---#
#-------------#---#
#--#-##########---#
#--#--------------#
#S#################