    ##N##
    #---########
    #-------#X-#
    #-----#X---#
    ########---#
           ##--#
######     #X--#
#----#     #-###
W----#     #--X#
#--###     ###-#
#---X#     ##X-#
#-##-#######---#
#------X#------#
##----#-#-####-#
#X-##-#X#--X---#
#-------###----#
#-##-####---#--#
#-XX--------#XX#
#######-X-######
      #-#-#
      #---#
      #---#
      #---#
      ##S##