    ##N##
    #---########
    #-------#--#
    #-----#----#
    ########---#
           ##--#
######     #---#
#----#     #-###
W----#     #---#
#--###     ###-#
#----#     ##--#
#-##-#######---#
#-------#------#
##----#-#-####-#
#--##-#-#------#
#-------###----#
#-##-####---#--#
#-----------#--#
#######---######
      #-#-#
      #---#
      #---#
      #---#
      ##S##