#####    ##N##
#---#    #---#
W---#    #-P-#
###-#    #---#
#X--#    ##-##
##--#    #X-X#
#--#######---#
#--X#X-------#
###-#--###-X-#
#X--#---X----#
#-######-#-X-#
#---V----#---#
##############