#####    ##N##
#---#    #---#
W---#    #---#
###-#    #---#
#X--#    ##-##
##--#    #X-X#
#--#######---#
#--X#X-------#
###-#--###-X-#
#X--#---X----#
#-######-#-X-#
#---X----#---#
##############