#####    ##N##
#---#    #---#
W---#    #---#
###-#    #---#
#---#    ##-##
##--#    #---#
#--#######---#
#---#--------#
###-#--###---#
#---#--------#
#-######-#---#
#--------#---#
##############