##N########################
##-------#------#---------#
###------#------#---------#
W-##-----#------####---####
#--##-------##-----##-----#
#---##--------------#-----#
#----##---##--##----#-----#
####--##------------#-----#
#------##---##------------#
#-#-##--##---------##-----#
#--------##############---#
#--#-##--#-----##---------#
#----------##--##-###-----#
#-#-#----#-----##-----#####
#---###############-###
#-#---#--------##-----#
#---#-#-##--#--##--#--#
#---#-------#--##--####
#############------#
            #-#----#
            ########