#######################
#----------##------##-#
#--######--#--####----#
#----##---------##--###
#----##---###---##----#
####-####--#-------####
   #-------#-------#
   ###--#-----###--#
   #----###-#-#---##
   #----#---#-#----#
   ####---###---####
      #---###---#
      ###-----###
      #---###---#
      #---------#
      ####---####
         #---#
         #---#
         #---#
         ##S##