###############################
#----------##-----##------#---#
###--#--------###---------#---#
#----#-----##-----##---#--##--#
#----#--------#-#------#------#
#-####-########S########--###-#
#------#---#       #------#---#
####---#---#       #-#----#---#
#------#---#       #-###--#---#
#---##-----#       #----------#
###-----##-#       #--##---####
#---##-----#       #-----#-#--#
###----#---#       #---#---#--#
#---#--#---#       #---#------#
############       ############