###############################
#X---------##--X--##------#-X-#
###--#------X-###---------#---#
#---X#-----##-----##---#--##X-#
#---X#--------#P#------#------#
#-####-########S########--###-#
#------#-V-#       #---X--#X--#
####---#---#       #-#----#---#
#------#---#       #-###--#---#
#---##-----#       #--X-------#
###-X---##-#       #--##---####
#X--##-----#       #-----#-#XX#
###----#---#       #---#-X-#--#
#X--#--#XXX#       #---#------#
############       ############