#######################
#---##-X--#-----------#
#--X---##-#------XX---#
#-##--V---#------##---#
W----------X-#--------#
#-#########--#----X---#
#------------#--#####-#
#---------X--#-----X--#
###############--X-##-#
              #-##-##-#
              #-##----#
              #----X--#
              #---#####
              #-X-----#
              #####---#
              #-----P-#
              ####S####