#######################
#---##----#-----------#
#------##-#-----------#
#-##------#------##---#
W------------#--------#
#-#########--#--------#
#------------#--#####-#
#------------#--------#
###############----##-#
              #-##-##-#
              #-##----#
              #-------#
              #---#####
              #-------#
              #####---#
              #-------#
              ####S####