#######################
#---##-X--#-----------#
#--X---##-#------XX---#
#-##------#------##---#
W----------X-#--------#
#-#########--#----X---#
#------------#--#####-#
#---------X--#-----X--#
###############--X-##-#
              #-##-##-#
              #-##----#
              #----X--#
              #---#####
              #-X-----#
              #####---#
              #-------#
              ####S####