###########
#---------#
#-##-##---#
#-----##--#
#--#------#
W--#--#---#
#--#--###-#   #######
#---------#   #-----#
#---###---#####-##--#
#-------------------#
#####S#########-##--#
              #-----#
              #######