###########
#--X--X---#
#-##-##---#
#----X##--#
#--#------#
W--#--#X--#
#--#--###-#   #######
#----X----#   #-X---#
#---###---#####-##-X#
#----------------X--#
#####S#########-##-X#
              #-X---#
              #######