###########
#-----P---#
#-##-##---#
#----X##--#
#--#------#
W--#--#X--#
#--#--###-#   #######
#----X----#   #-X---#
#---###---#####-##-X#
#----------------XV-#
#####S#########-##-X#
              #-X---#
              #######