##########
W--------#
#--------#
#######--#
#--------#
#-##--##-#
#-##--##-#
#--------#
#-#####--#
#-#---#--#
#-#-#-#--#
#---#----#
##########