##########
W--P-----#
#--------#
#######--#
#---XX---#
#-##--##-#
#-##--##-#
#--X--X--#
#-#####--#
#-#-V-#--#
#-#X#-#--#
#X--#---X#
##########