        #######################
        #------##-----##------#
        #---##-##--##--#--##--#
        #---------------------#
        ##--###############-#-#
        #---#             #---#
        #---#             #-#-#
        ###-###############---#
        #---------------------#
#########---------------------#
#-----#-----###############-#-#
W--#--#--##-#             #-#-#
#--#--------###############-#-#
#########---------------------#
        #---------------------#
        ###-###############---#
        #---#             #-#-#
        #---#             #---#
        ##--###############-#-#
        #---------------------#
        #---##-##--##--#--##--#
        #------##-----##------#
        #######################